abwassers	NN	abwasser
abwasser	NN	abwasser
reinigung	NN	reinigung
reinigungen	NN	reinigung
anzeige	NN	anzeige
anzeigen	NN	anzeige
anzeigen	V	anzeigen
tafel	NN	tafel
tafeln	NN	tafel
dampf	NN	dampf
turbine	NN	turbine
turbinen	NN	turbine
anlage	NN	anlage
anlagen	NN	anlage
energie	NN	energie
gewinnung	NN	gewinnung
kreislauf	NN	kreislauf
kreisläufe	NN	kreislauf
kreis	NN	kreis
kreise	NN	kreis
kreisen	V	kreisen
lauf	NN	lauf
breit	ADJ	breit
breites	ADJ	breit
breiter	ADJ	breit
breitem	ADJ	breit
flügel	NN	flügel
fledermäuse	NN	fledermaus
fledermaus	NN	fledermaus
huhn	NN	huhn
hühner	NN	huhn
suppe	NN	suppe
suppen	NN	suppe
teller	NN	teller
energiegewinnung	NN energiegewinnung
freitag	NN	freitag
frei	ADJ	frei
tag	NN	tag
adria	NE	adria
achilles	NE	achilles
küste	NN	küste
ferse	NN	ferse
regel	NN	regel
position	NN	position
auf	PART	auf
licht	NN	licht
mikroskop	NN	mikroskop
abseits		ADV	abseits
vorrichtung	NN	vorrichtung
hängen	V	hängen
aufhängen	V	aufhängen
atmen	V	atmen
atem	NN	atem
gerät	NN	gerät
maschine	NN	maschine
tauchen	NN	tauchen
